//MAP CONVERTED BY dmm2tgm.py THIS HEADER COMMENT PREVENTS RECONVERSION, DO NOT REMOVE
"aP" = (
/turf/closed/shuttle/dropship3/tornado{
	icon_state = "76";
	name = "\improper Shitfuck"
	},
/area/shuttle/shitfuck)
"bm" = (
/turf/closed/shuttle/ert{
	icon_state = "leftengine_11";
	opacity = 0
	},
/area/shuttle/shitfuck)
"cK" = (
/turf/open/floor/plating,
/area/shuttle/shitfuck)
"dd" = (
/obj/structure/shuttle/part/tornado/transparent{
	icon_state = "40";
	density = 0;
	layer = 4.2;
	name = "\improper Shitfuck"
	},
/obj/structure/shuttle/part/tornado/transparent/nosecone{
	icon_state = "102"
	},
/turf/template_noop,
/area/shuttle/shitfuck)
"dB" = (
/turf/closed/shuttle/dropship3/tornado{
	icon_state = "46";
	name = "\improper Shitfuck"
	},
/area/shuttle/shitfuck)
"dE" = (
/turf/closed/shuttle/dropship3/tornado{
	icon_state = "30";
	name = "\improper Shitfuck"
	},
/area/shuttle/shitfuck)
"fF" = (
/obj/structure/bed/chair/vehicle/dropship_cockpit/pilot{
	dir = 1
	},
/obj/structure/machinery/computer/shuttle/dropship/flight/screen{
	pixel_y = 23
	},
/turf/open/floor/plating,
/area/shuttle/shitfuck)
"gw" = (
/obj/effect/attach_point/fuel/shitfuck{
	pixel_y = -17;
	pixel_x = 2
	},
/turf/closed/shuttle/ert{
	icon_state = "T61"
	},
/area/shuttle/shitfuck)
"hL" = (
/obj/effect/decal/warning_stripes{
	icon_state = "S";
	pixel_y = 2
	},
/obj/effect/decal/warning_stripes{
	icon_state = "N";
	pixel_y = -1
	},
/turf/open/shuttle/dropship/light_grey_single_wide_up_to_down,
/area/shuttle/shitfuck)
"ls" = (
/turf/closed/shuttle/ert{
	icon_state = "upp_leftengine"
	},
/area/shuttle/shitfuck)
"mh" = (
/turf/closed/shuttle/dropship3/tornado{
	icon_state = "49";
	name = "\improper Shitfuck"
	},
/area/shuttle/shitfuck)
"mA" = (
/turf/closed/shuttle/dropship3/tornado{
	icon_state = "75";
	name = "\improper Shitfuck"
	},
/area/shuttle/shitfuck)
"oy" = (
/obj/structure/machinery/light/double{
	dir = 1
	},
/obj/structure/largecrate/random,
/obj/structure/largecrate/random/barrel/green{
	pixel_y = -15
	},
/obj/structure/largecrate/random/mini{
	pixel_x = 3;
	pixel_y = 14
	},
/turf/open/floor/plating,
/area/shuttle/shitfuck)
"oB" = (
/obj/effect/attach_point/electronics/midway,
/obj/structure/shuttle/part/tornado/transparent{
	icon_state = "41";
	layer = 4.2;
	density = 0;
	name = "\improper Shitfuck"
	},
/turf/template_noop,
/area/shuttle/shitfuck)
"oG" = (
/obj/effect/decal/warning_stripes{
	icon_state = "S";
	pixel_y = 2
	},
/obj/effect/decal/warning_stripes{
	icon_state = "N";
	pixel_y = -1
	},
/obj/structure/machinery/door/airlock/multi_tile/almayer/dropshiprear/ds3{
	id = "aft_door";
	name = "\improper Shitfuck cargo door"
	},
/turf/open/shuttle/dropship/light_grey_single_wide_up_to_down,
/area/shuttle/shitfuck)
"rr" = (
/turf/closed/shuttle/dropship3/tornado{
	icon_state = "18";
	name = "\improper Shitfuck"
	},
/area/shuttle/shitfuck)
"rR" = (
/turf/closed/shuttle/ert{
	icon_state = "rightengine_3";
	opacity = 0
	},
/area/shuttle/shitfuck)
"sl" = (
/turf/closed/shuttle/dropship3/tornado{
	icon_state = "25";
	name = "\improper Shitfuck"
	},
/area/shuttle/shitfuck)
"tT" = (
/obj/structure/shuttle/part/tornado/transparent{
	icon_state = "40";
	density = 0;
	layer = 4.2;
	name = "\improper Shitfuck"
	},
/turf/template_noop,
/area/shuttle/shitfuck)
"us" = (
/obj/structure/bed/chair{
	dir = 4;
	pixel_y = 3
	},
/turf/open/floor/plating,
/area/shuttle/shitfuck)
"uu" = (
/obj/effect/decal/cleanable/dirt,
/obj/structure/closet/crate/supply{
	density = 0;
	pixel_y = 26;
	name = "rappel harness crate"
	},
/obj/item/rappel_harness/extract/shitfuck,
/obj/item/rappel_harness/extract/shitfuck,
/obj/item/rappel_harness/extract/shitfuck,
/obj/item/rappel_harness/extract/shitfuck,
/obj/item/rappel_harness/extract/shitfuck,
/obj/item/rappel_harness/extract/shitfuck,
/obj/item/rappel_harness/extract/shitfuck,
/obj/item/rappel_harness/extract/shitfuck,
/obj/item/rappel_harness/extract/shitfuck,
/turf/open/floor/plating,
/area/shuttle/shitfuck)
"yB" = (
/turf/closed/shuttle/dropship3/tornado{
	icon_state = "31";
	name = "\improper Shitfuck"
	},
/area/shuttle/shitfuck)
"zm" = (
/turf/closed/shuttle/ert{
	icon_state = "leftengine_2";
	opacity = 0
	},
/area/shuttle/shitfuck)
"zG" = (
/obj/structure/bed/chair/dropship/passenger{
	dir = 4
	},
/turf/open/floor/plating,
/area/shuttle/shitfuck)
"Bk" = (
/obj/structure/shuttle/part/tornado/gunpod_prop{
	name = "\improper Shitfuck"
	},
/turf/template_noop,
/area/shuttle/shitfuck)
"Bn" = (
/turf/closed/shuttle/dropship3/tornado{
	icon_state = "24";
	name = "\improper Shitfuck"
	},
/area/shuttle/shitfuck)
"BS" = (
/turf/closed/shuttle/ert{
	icon_state = "upp_rightengine"
	},
/area/shuttle/shitfuck)
"BU" = (
/turf/closed/shuttle/ert{
	icon_state = "rightengine_11";
	opacity = 0
	},
/area/shuttle/shitfuck)
"CX" = (
/turf/closed/shuttle/dropship3/tornado{
	icon_state = "76"
	},
/area/shuttle/shitfuck)
"Db" = (
/turf/closed/shuttle/ert{
	icon_state = "rightengine_2";
	opacity = 0
	},
/area/shuttle/shitfuck)
"Dg" = (
/obj/structure/bed/chair{
	dir = 8
	},
/turf/open/floor/plating,
/area/shuttle/shitfuck)
"DO" = (
/obj/structure/bed/chair{
	dir = 8
	},
/obj/effect/decal/cleanable/dirt,
/turf/open/floor/plating,
/area/shuttle/shitfuck)
"Fu" = (
/obj/effect/decal/warning_stripes{
	icon_state = "S";
	pixel_y = 2
	},
/obj/effect/decal/warning_stripes{
	icon_state = "N";
	pixel_y = -1
	},
/turf/open/shuttle/dropship/medium_grey_single_wide_up_to_down,
/area/shuttle/shitfuck)
"Kw" = (
/turf/template_noop,
/area/template_noop)
"Ln" = (
/turf/closed/shuttle/dropship3/transparent{
	icon_state = "97a"
	},
/area/shuttle/shitfuck)
"Lr" = (
/turf/closed/shuttle/dropship3/tornado{
	icon_state = "19";
	name = "\improper Shitfuck"
	},
/area/shuttle/shitfuck)
"NK" = (
/obj/structure/machinery/light/double{
	dir = 1
	},
/obj/structure/bed{
	can_buckle = 0
	},
/obj/item/bedsheet/brown{
	layer = 3.4
	},
/turf/open/floor/plating,
/area/shuttle/shitfuck)
"Pb" = (
/obj/docking_port/mobile/marine_dropship/shitfuck,
/obj/effect/attach_point/crew_weapon/shitfuck,
/turf/open/floor/plating,
/area/shuttle/shitfuck)
"PW" = (
/turf/closed/shuttle/dropship3/tornado{
	icon_state = "83";
	name = "\improper Shitfuck"
	},
/area/shuttle/shitfuck)
"Qk" = (
/obj/effect/attach_point/fuel/shitfuck{
	pixel_x = -34;
	pixel_y = -17
	},
/turf/closed/shuttle/ert{
	icon_state = "T151"
	},
/area/shuttle/shitfuck)
"TE" = (
/obj/structure/shuttle/part/tornado/transparent{
	icon_state = "41";
	layer = 4.2;
	density = 0;
	name = "\improper Shitfuck"
	},
/obj/structure/shuttle/part/tornado/transparent/nosecone{
	icon_state = "100"
	},
/turf/template_noop,
/area/shuttle/shitfuck)
"WF" = (
/obj/effect/decal/cleanable/dirt,
/turf/open/floor/plating,
/area/shuttle/shitfuck)
"XS" = (
/obj/effect/decal/cleanable/dirt,
/obj/structure/bed/chair/dropship/passenger{
	dir = 8
	},
/turf/open/floor/plating,
/area/shuttle/shitfuck)
"YV" = (
/obj/effect/decal/cleanable/dirt,
/obj/structure/bed/chair{
	dir = 8;
	layer = 4
	},
/turf/open/floor/plating,
/area/shuttle/shitfuck)
"Zu" = (
/turf/closed/shuttle/ert{
	icon_state = "leftengine_3";
	opacity = 0
	},
/area/shuttle/shitfuck)

(1,1,1) = {"
Kw
Kw
Kw
Kw
Kw
Kw
Kw
Kw
Kw
Kw
"}
(2,1,1) = {"
Kw
Kw
Kw
gw
ls
Zu
zm
bm
Kw
Kw
"}
(3,1,1) = {"
Kw
tT
mA
rr
dE
Bn
rr
rr
dB
Kw
"}
(4,1,1) = {"
Kw
TE
CX
NK
uu
us
zG
us
oG
Kw
"}
(5,1,1) = {"
Kw
Bk
Ln
fF
cK
Pb
cK
WF
Fu
Kw
"}
(6,1,1) = {"
Kw
dd
aP
oy
YV
XS
DO
Dg
hL
Kw
"}
(7,1,1) = {"
Kw
oB
PW
Lr
yB
sl
Lr
Lr
mh
Kw
"}
(8,1,1) = {"
Kw
Kw
Kw
Qk
BS
rR
Db
BU
Kw
Kw
"}
(9,1,1) = {"
Kw
Kw
Kw
Kw
Kw
Kw
Kw
Kw
Kw
Kw
"}
